###############
#A#     #     #
# # ### # ### #
#   # # #   # #
##### ##### # #
#     #     # #
# ### ### ### #
#   #     #   #
##### ### #####
#     #     #B#
###############
