#############
#A#   #     #
# # # # ### #
# # #   #   #
# ### ### ###
#     #     #
### ### ### #
#     #     #
### ##### ###
#B           #
#############
